############################################################
##i  *         @               *                         i## 
##  ########################################################  
##  ##          
##  ##             
##  ##  
##  ########################################################    
##   *                         *                         i##
##  ########################################################  
##  ##    
##  ##      
##  ##
##  ########################################################    
##   *                         *                         i##
##  ########################################################  
##  ##
##  ##
##  ##
##  ########################################################    
##   *                         *                         i##
##  ########################################################  
##  ##                            
##  ##
##  ##               
##  ########################################################    
##   *                         *                         i##
##i ########################################################  
##  ##
##0 ##
######                                             
