           ##################               ################
           ##              ##               ##i           ##
           ##   i     i    ##               ##  *    i    ##  
           ##      *       ##               ##            ##   
           ##              ##               ############  ##    
           ##############  ##                         ##  ##
                       ##  ##                         ##  ##
                       ##  #############################  ##
                       ##                                 ##
                       ##                                 ##
    #####################  *               *              ##
    ## *                                                  ##
    ##  #################                                 ##
    ##  ##             ##                      *          ##
    ##  ##             ##  i          i                   ##
    ##  ##             ##                      *        0 ##
    ##  ##             ##                                 ##
    ##  ##             ##                                 ##
    ##  ##             ##  *               *              ##
    ##  ##             ##                                 ##
    ##  ##             ##                                 ##
    ##  ##             ##  #############################  ##
    ##  ##             ##  ##                         ##  ##               
    ##  ## ##############  ##                         ##  ##                
    ##  ## ##              ##               ############ i##   
    ##  ## ##      *       ##               ##            ##      
######  #####   i      i   ##               ##  i  *      ##       
##        ###              ##               ##            ##        
## i  @   ###################               ################         
##        ##                                               
############                                                
